02,02,02,02,02,02,02,02,02,02,02,02,02,02,02,02,05,06,07,08,05,06,07,08,05,06,07,08,05,06,07,08
02,02,02,02,02,02,02,02,02,02,02,02,02,02,02,02,05,06,07,08,05,06,07,08,05,06,07,08,05,06,07,08
02,02,02,02,02,02,02,02,02,02,02,02,02,02,02,02,05,06,07,08,05,06,07,08,05,06,07,08,05,06,07,08
02,02,02,02,02,02,02,02,02,02,02,02,02,02,02,02,05,06,07,08,05,06,07,08,05,06,07,08,05,06,07,08
03,03,03,03,03,03,03,03,03,03,03,03,03,03,03,04,05,06,07,08,05,06,07,08,05,06,07,08,05,06,07,08
03,03,03,03,03,03,03,03,03,03,03,03,03,03,03,04,05,06,07,08,05,06,07,08,05,06,07,08,05,06,07,08
03,03,01,01,01,01,01,01,01,01,01,01,01,01,01,01,05,06,07,08,05,06,07,08,05,06,07,08,05,06,07,08
01,01,01,01,01,01,01,01,01,01,01,01,01,01,01,01,05,06,07,08,05,06,07,08,05,06,07,08,05,06,07,08
01,01,01,01,01,01,01,01,01,01,01,01,01,01,01,01,05,06,07,08,05,06,07,08,05,06,07,08,05,06,07,08
01,01,01,01,01,01,01,01,01,01,01,01,01,01,01,01,05,06,07,08,05,06,07,08,05,06,07,08,05,06,07,08
01,01,01,01,01,01,01,01,01,01,01,01,01,01,01,01,05,06,07,08,05,06,07,08,05,06,07,08,05,06,07,08
03,03,03,03,03,03,03,03,03,03,03,03,03,03,03,04,05,06,07,08,05,06,07,08,05,06,07,08,05,06,07,08
03,03,03,03,03,03,03,03,03,03,03,03,03,03,03,04,05,06,07,08,05,06,07,08,05,06,07,08,05,06,07,08
03,03,03,03,03,03,03,03,03,03,03,03,03,03,03,04,05,06,07,08,05,06,07,08,05,06,07,08,05,06,07,08
03,03,03,03,03,03,03,03,03,03,03,03,03,03,03,04,05,06,07,08,05,06,07,08,05,06,07,08,05,06,07,08
03,03,03,03,03,03,03,03,03,03,03,03,03,03,03,04,05,06,07,08,05,06,07,08,05,06,07,08,05,06,07,08
02,02,02,02,02,02,02,02,02,02,02,02,02,02,02,02,05,06,07,08,05,06,07,08,05,06,07,08,05,06,07,08
02,02,02,02,02,02,02,02,02,02,02,02,02,02,02,02,05,06,07,08,05,06,07,08,05,06,07,08,05,06,07,08
02,02,02,02,02,02,02,02,02,02,02,02,02,02,02,02,05,06,07,08,05,06,07,08,05,06,07,08,05,06,07,08
02,02,02,02,02,02,02,02,02,02,02,02,02,02,02,02,05,06,07,08,05,06,07,08,05,06,07,08,05,06,07,08
03,03,03,03,03,03,03,03,03,03,03,03,03,03,03,04,05,06,07,08,05,06,07,08,05,06,07,08,05,06,07,08
03,03,03,03,03,03,03,03,03,03,03,03,03,03,03,04,05,06,07,08,05,06,07,08,05,06,07,08,05,06,07,08
03,03,01,01,01,01,01,01,01,01,01,01,01,01,01,01,05,06,07,08,05,06,07,08,05,06,07,08,05,06,07,08
01,01,01,01,01,01,01,01,01,01,01,01,01,01,01,01,05,06,07,08,05,06,07,08,05,06,07,08,05,06,07,08
01,01,01,01,01,01,01,01,01,01,01,01,01,01,01,01,05,06,07,08,05,06,07,08,05,06,07,08,05,06,07,08
01,01,01,01,01,01,01,01,01,01,01,01,01,01,01,01,05,06,07,08,05,06,07,08,05,06,07,08,05,06,07,08
01,01,01,01,01,01,01,01,01,01,01,01,01,01,01,01,05,06,07,08,05,06,07,08,05,06,07,08,05,06,07,08
03,03,03,03,03,03,03,03,03,03,03,03,03,03,03,04,05,06,07,08,05,06,07,08,05,06,07,08,05,06,07,08
03,03,03,03,03,03,03,03,03,03,03,03,03,03,03,04,05,06,07,08,05,06,07,08,05,06,07,08,05,06,07,08
03,03,03,03,03,03,03,03,03,03,03,03,03,03,03,04,05,06,07,08,05,06,07,08,05,06,07,08,05,06,07,08
03,03,03,03,03,03,03,03,03,03,03,03,03,03,03,04,05,06,07,08,05,06,07,08,05,06,07,08,05,06,07,08
03,03,03,03,03,03,03,03,03,03,03,03,03,03,03,04,05,06,07,08,05,06,07,08,05,06,07,08,05,06,07,08